prev_query	query
Россия U20 - Германия U20 водное поло	жк берег воронеж купить квартиру
христианская песня прости господь наш неверный род	как сделать ручку на крышку корзинки
солнышко как играть на пианино	долгота и широта с шангала петровский район ул 60 лет октября
На какой срок накладывается давящая повязка после удаления (экстирпации) поднижнечелюстной железы:	Село страчево Брянская
Что значит внедрение культур	Частные клиники проверить вены псков
мессия это	а я по полюшку по полюшку приду к тебе за тысячу верст
Пардо, Джей Ди	ручка переключения передач опель астра j акпп купить
как сочинить докучную сказку образец	ю малахова вороне
Кустарники с названием	математика 6 класс страница 17 номер 90
Парадная форма сотрудников фсин нового образца	популярные проктологи києва
насадки для гравера как называются	каталог орифлейм 15 2021 года
струбцина купить в саратове	ПЛАН УРОКА ПО ФИЗИКЕ 8 КЛ БЕЛАГА 2 УРОК
как убрать закон рф что дети инвалиды должны сдавать экзамены	купить двутавр в волгограде
телеобъединение сфера 3 я новоостанкинская 4	ликон инструмент официальный сайт
minecraft emo teens	строим баню из газобетона своими руками поэтапный показ строительства
На какой срок накладывается давящая повязка после удаления (экстирпации) поднижнечелюстной железы:	cold steel kudu купить в москве недорого
октябрьская 107 омск	люхов юрий барановичи
идеи домиков для уличных кошек самодельные не из дерева	Кому положена выплата от 8 до 16 лет
как ходили в туалет в пышных платьях в 18 веке	тренировка печати на клавиатуре о
Раповка слушать	новости долгоруково липецкой области криминальные новости
кимер волгодонск мебельная фабрика	какая кожа подойдет для драпового пальто
за какое время автомобиль двигаясь с ускорением 0.4 м/с2 увеличит свою скорость с 12 до 20 м/с	грипп птиц
наличие устойчивых связей 44 фз	тело в виде сахарной головы 5 букв ответ угадай
толокно это 6 класс	скидки виталюр
альфа центр здоровья ярославль телефон регистратуры на советской	нужно ли отсасывать аквамарис
регулярки для русских слов	центр продаж новостроек жк кузнецкий
форд эскейп	кого можно вызвать из духов безобидных без свечей
Crosman Vantage Copperhead	В какой срок работодатель обязан выдать экземпляр акта о несчастном случае на производстве пострадавшему после завершения расследования несчастного случая?
ИНН 3811056264	кортни кокс википедия
ЕСПД описание программы	дневник е.
холостяк на свадьбе смотреть онлайн бесплатно фильм 2020 в хорошем качестве все	почему отключается духовка нефф
что можно подарить девочке на 12 лет	цирроз печени по мкб
больше меньше знаки	мирослава тик ток таролог
выбытие из кассы организации на лицевой счет казначейства проводка в бюджетном учреждении	фунгициды для роз
сосет с завязанными глазами	тик ток тимура бекмамбетова
однородные члены в предложении	верхняя балкария осенью
снять 1 кварт в есентуках без прсредника	Таблица косинусов и синусов нестандартных углов
6.sınıf FM Yayıncılık ders kitabı din kültür	orang cewek cantik susu besar porno
luxury mur все видео смотреть онлайн	тренировка печати на клавиатуре о
москва казанская	Таблица косинусов и синусов нестандартных углов
Парадная форма сотрудников фсин нового образца	кто виноват если один участник не уступил дорогу а другой превысил
ооо ре трэйдинг	кинофильмы о войне 1941-1945 новинки отечественные
пошлая молли	сайт мцб октябрьского района
а я по полюшку по полюшку приду к тебе за тысячу верст	джаз фм
школьница снимается голой	май литл пони смотреть zetserials
"Окружающий мир ""Моя малая Родина"" 2-4 класс. Учебное пособие. ФГОС 2019 | Корецкая Т.Л., Коровин С.Е."	малышенко кирилл грантович
рабочий сапоги и ботинки цена минстирал	porno Masha Katieva
gta 5 script hook v net	15 а автобус брест
кто освобождается от налога на дарение недвижимости	марш беккали мое имя в красно отзывы
центр агапит	1080 фильмы онлайн в хорошем качестве hd 1080
КЛУБ USAVTO	елена кульченкова ессентуки
что в повести временных лет предшествовало походу владимира на корсунь	сыр сулугуни запеченный в слоеном тесте рецепт
IBEROSTAR SELECTION CANCUN (EX. HILTON CANCUN GOLF & SPA RESORT) 5*	михаил гащук ростов на дону
какой вуз закончил каспаров гарри кимович	Москвы нк бывает
дистанционное обучение в киеве 2021	честер обувь сургут сайт официальный
Экстрасенс умер в хостеле	хасанов шамиль аглямович биография
кончают в маленькую попку	Уровень строительный КОБАЛЬТ Экстра, 1000 мм, профиль 23 x 59 мм, 3 глазка, точность 0,5 мм/м
алгебра 9 класс макарычев	я тебе подарю на закате зарю текст
есенин пугачёвкраткое содержание	моды симс на причёски для женщин 4
	+ песни demons со словами
охотники за привидениями мультфильм все серии	строительная компания контур липецк телефон
за чашечкой кофе яндекс дзен	прилагательные качественные относительные притяжательные таблица 6 класс
люмакс техподдержка	гдз по английскому языку 4 класс учебник 1 часть моро стр 5 упр 4
Что должно иметь решающее значение при выборе водителем скорости движения в темное время суток?	майл ру э
hodis moc	куда можно поехать отдыхать в декабре 2021 с детьми
Птичка лохматик	"Шина PE ""земля"" на DIN-изоляторе ШНИ-6х9-12-Д-Ж IEK YNN10-69-12D-K05"
A 013 997 72 46	предложение со словом этика
как перенастроить шкалу расходомера дм-1	сборник г. Донецк 2000г Литенко
ГОСТ 1938-90	красивые авы на группу
восприняла углубить заняв сливовый поняла	скачать песню маловой 10 заповедей
PARROTEL AQUA PARK RESORT (EX. PARK INN BY RADISSON) 4*	вид деятельности (ОКВЭД),
nonton film	однородные члены в предложении
"роль наблюдения в психологической науке?"" сочинение эссе"	клипы меладзе скачать
саундтреки из фильма любовь по расчету 2019 комедия	флора и фауна новой зеландии
где в россии проходит линия перемены дат в беринговом проливе по 180 меридиану 100 в.д	собрать свою кио рио
Как стать самозанятым	жена шохина
продажа панели мдф дуб каньон киров	как звали гулливера
калининград фотоспа на берегу млр	xxnx Indonesia Open bo
когда приносят чудотворную икону в елохове	русский язык 4 класс 1 часть учебник канакина гдз
торт генио кидс	судебный участок  64 череповец
программа передач	порно 2 негра вызвали белую проститутку и снимают на телефон
Птичка лохматик	какими морями омывается атлантический океан
Психолого-педагогическое сопровождение внедрения инновационных технологий	ООО СПМКРАН
над зеленым значком	армавир промзона 30 спец
сколько стоит вывести татуировку	клетка прокариот вакуоль с клеточным соком
фрезерный станок по  рейтинг	беременна в 16 нерусский жених серия
полукруг проверочное слово	jacket payday 2 voice lines wav
точный прогноз матча нс мура витесс	папа джонс
к единственному нежному успенская	сор по литературе 8 класс распутин уроки французского
мстители финал фильм 2019 скачать	bl telese relays
купить канализационную задвижку и клапан обратный	предельные издержки рассчитываются по формуле
дк ленсовета санкт-петербург официальный сайт афиша	коэффициент вариации больше 100 процентов почему
краснояружский район администрация официальный сайт	формула икс для решения квадратных уравнений
новости долгоруково липецкая область	слушать юрий шатунов все
какие бывают методы и приемы в детском саду	LUXURY BAHIA PRINCIPE SIAN KA'AN (EX. GRAN BAHIA PRINCIPE SIAN KAAN DON PABLO COLLECTION) 5*
минимальный размер пенсии в ленинградской области в 2021 году по старости	мечел форум
Раповка слушать	gtx 1050
танец скачать жиота	параметры фигуры моника белучи
электролобзик  на авито в спб	я тебе подарю на закате зарю текст
авито Калининград хомяки	таблетка от голода 7 букв сканворд
Скачать песню а мы не из фильма	Рабочая тетрадь страница 5 задание 4 русский
госуслуги личный	LUXURY BAHIA PRINCIPE SIAN KA'AN (EX. GRAN BAHIA PRINCIPE SIAN KAAN DON PABLO COLLECTION) 5*
как называется лагерь для войск	КЛУБ AVTOUSA
концерт малинина в 2019 году в москве	октябрьская 107 омск судебный участок
не чувствует запахи	Чулки Mademoiselle Marta 40 (aut)
индивидуальные смыслы болезни это	поправка 22 фильм 2019
Текст песни до мурашек	Несчастный случай в киевском метро
Козерог и его бумеранг обидчику	что такое ротация фото
рэн 29 содержание драгметаллов цена на лом	когда кастрировать шотландца вислоухого
оперу спб гту банка россии адрес	прибаутки это определение для детей 2 класса
сайт сулпак	листопад турецкий сериал русская озвучка
Английский язык стр 44 упр 9	новости долгоруково липецкой области криминальные новости
мама-кот театр маяковского продолжительность спектакля	Кому положена выплата от 8 до 16 лет
свойство хорошей речи содержательность	выставки санкт-петербург на май
какое заявление нужно подать за долгое возбуждение уголовного дела	торрент секс
кино жемчужная плаза	фильтроэлемент TFX-400X10
древесина для ботаника 7 букв сканворд	стадион заря самара
айна песня	министерство просвещения и министерство образования в чем разница
как образуется пептидная связь	кортни кокс википедия
кашель у ребёнка без температуры	тгк-14 улан-удэ официальный сайт
кайо тор 250 2020	Определите органоиды по описанию: форма цилиндрическая, стенка состоит из белковых молекул (тубулин), расположены диффузно в цитоплазме:
слушать современную музыку	дефлекторы окон rein на форд фокус 3 универсал описание характеристики
внутренняя ручка двери ваз 2107 подходит на ниву 21213	скачать картинку королеву красок для детей анимационные
Газ 53 салон	если не сдал егэ биологию как пройти
микрометры МН-2	Египет отель тропитель
Физиологическая и репаративная регенерация эпителия	отключить местоположение в яндексе
спотлайт 5 класс сборник упражнений читать онлайн бесплатно без регистрации с текстом	порно жопастые за деньги
стеклянные душевые кабины под заказ ростов-на-дону	шефская 2г екатеринбург автосалон хендай
картридж для brusko minican	патриот 2 смотреть онлайн
скачать кино форсаж узбек тилида	Конф Няшка-вкусняшка вес**
погода в москве	стиральная машинка samsung dc68-00682 не реагирует на включение
купить коляску в тюмени рич фэмили	александр 1
университет дружбы народов имени патриса лумумбы	все реперы черные а я просто парень на стиле из фильма
angry birds pop bomb	84545sl pelle navy
песня florida low ремикс словед	в структуре реализации экономичных механизмов выделяют 2 основных элемента государственный негосударственный экономическое пространство
количество аргументов в функции лисп	не обследованные женщины должны поступать на роды куда
кдл пенза режим работы	Что такое речь
отрывок на живую классику питэр пен	sims 4 параметры игры
гдз по геометрии 9 класс атанасян	скачать кино фарсаж узбек тйлйда
все по кайфу ведь я у руля скачать	гдз по английскому языку 4 класс учебник 1 часть моро стр 5 упр 4
у лукоморья дуб зеленый нарисовать рисунок карандашом легко	фестиваль черный кот 2021 рязань выступление смотреть онлайн
произведение михаила ивановича глинки и его характеристику	сафин ринат раисович пристав телефон
милованов виктор его достижения	установлено ограничение связи пополните баланс или обратитесь к оператору
Газ 53 салон	той купить в донецкой области
фильмы новые	read the rubric. put the events into the correct order. big waves
архипо-осиповка отдых	наличие устойчивых связей 44 фз - что это
Круч как пишется	цветовая палитра xml
не активна кнопка база на гранд смета.ру	камеди клаб 2021
Вопрос 14.  Машина для брошюровки проволокой отпечатанных листов книг, журналов и т. п.	елена кульченкова ессентуки
русский ваятель воспитанник академии сей художник единственный до некоторой степени известный	жк озерки воронеж
купить швеллер в волгограде	казанский вокзал на карте метро
синтаксический разбор предложения	запсибовцев 4б новокузнецк индекс
ира грачева донецк в вк	скачать mirrors edge
от фритюров масла какая польза или вред	п. Малая Сосновка, СК «Животновод»
транзиторная зона зона левой доли предстательной железы	рифма доброты
технопоинт абакан каталог товаров	наруто саске пародия
Частные клиники псков	струбцина f купить в саратове
с каким поселком граничит махмутлар	тыквы фикс прайс фигурка керамика сентябрь 2021
окр мир 2 класс 1 часть	как находить арккосинус
транзиторная зона зона левой доли предстательной железы	доллар новосибирск
календарь магнитных бурь на сентябрь 2021 года	долгота и широта с шангала петровский район ул 60 лет октября
Рифма к слову сделан	вот как то так но никак иначе песня
александр шустров	kyocera m2635dn scanner driver
Динамическая Задержка плагин	скачать песню Аби маме Мешкова в мешково
определение ВАС РФ от 10 января 2007 г. по делу № А39-5033/06-52/5  ?сточник: https://www.buhgalteria.ru/article/sushchestvennye-usloviya-dogovora-kak-soglasovat © Бухгалтерия.ру	старлайн а91 отключение сигнализации без брелка аварийное
меркантилизм экономическая теория АВТОР	битл по имени ринго 5
список Доп мест в астраханской академии коммерция	дата выхода 5 сезона звездные войны повстанцы
консультация семейного психолога	Об определении базового уровня тарифов на перемещение и хранение задержанных транспортных средств на территории Республика башкортостан
наушники панасоник заушные	размножение коров
ближайший транспорт на ул добролюбова	померанский шпиц мини купить в екатеринбурге питомник
градация как стилистическая фигура	84545sl pelle navy
скачать фильмы привет андрей любимый табор возвращается через торрент бесплатно в хорошем качестве без регистрации	рейтинг букмекеров
Аптека краснозаводск рядом с пятерочкой	musica tvoya трек
у эукариот одновременно транскрибируется днк	судебная работа что это
аферистка смотреть онлайн	велосипедист съехал с горки за 10 секунд двигаясь с постоянным ускорением 0.6 м/с2 определите длину
chimildiq haqida mp3 skachat muxriddin xoliqov mp3	найти сварщика на разовую работу
армин ван бюрен альбомы скачать	жёлтый треугольник с восклицательным знаком pnh
рисунки на тему против терроризма	произведение михаила ивановича глинки и  характеристику произведения
заключение контрактов в детских садах по 44 закону	за кого на губернаторских выборов выборах будет голосовать Дальний Восток Хабаровский край
Конфликт в переводе с латинского означает:	фото пробуем с женой помпу
электронный дневник	ситроен джампер предохранитель дворников
2 d 16	почему устройство айон представляет больше риска чем другие вычислительные устройства
стеллокс амортизаторы передние отзывы автовладельцев	Безнадежный разделить на слоги
анна и эльза маленькие обнимаются	топ сайт с пиктограммами по использованию изделий медицинского
огонь сериал 2020 смотреть онлайн	5.8 Mh/s
составь неболешой  устный  расказпо  по  рисунку  кактты  его  озаглавишь  какой ре	порно кончил в азиатку
самопересекающаяся области 	5 кубков таро сочетание
136 маршрут тольятти схема движения	что можно подарить девочке из украшений на 12 лет
Мезотелий (однослойный плоский эпителий) выстилает:	Колонки 2.0 SVEN SPS-611S
Антонимы к слову каникулы	для повышения гемоглобина смесь сухофруктов с медом
что означают белые выделения у подростка	скайрим мод на броню для девушек магов
стилистические возможности языковых средств	маленький принц мультфильм экзюпери 1990
приточный клапан кив-125 характеристики	скачать аниме обещанный неверленд 1 сезон
happy wheels порно	чем обеспечивается наследование обществознание 6 класс боголюбов фгос
как называется лагерь для войск	osbourne ozzy - black rain - guitar tab pdf
IBEROSTAR SELECTION CANCUN (EX. HILTON CANCUN GOLF & SPA RESORT) 5*	окружающий мир 3 класс рабочая тетрадь 1 часть плешаков ответы
Какая языковая функция связана с художественной литературой нет языковая эстетическая	293 ук рф халатность
Журавли текст	академик константинов борис павлович
бот вк для беседы	гдз по английскому 6 класс starlight учебник
882 год событие	84545sl pelle navy
работа в вологде свежие вакансии от прямых работодателей	элементы смешанного договора это
ава казань запись на прием	институт клинической психологии
ленобласть токсово щап-	рыболовные выставки 2021 в казани
школа 56 киров официальный сайт киров	dynamic delay плагин
Медикаментозный аборт	живая планета калининград программа передач на сегодня в калининграде на неделю следующую неделю стс
антивирусные препараты от простуды	огэ 2020 А.Ю.Берсерк русский язык гдз 
кинотеатр мир барнаул афиша расписание на завтра	ванпанчмен 2
шумовая музыка слушать	Классификация стрептококков. Деление стрептококков на серогруппы по Р. Лэндсфилд.
сопли после садика у ребенка постоянно	обрезками проверочное слово
корень в слове унес	работа на фритюров какой виед или польза и вред
Крахмал условия и сроки хранения	папа джонс
папины дочки смотреть онлайн	Вычислите массу одной молекулы: а) водорода
заячья продажная душа человека	Юла Калининград хомяки
в каком мфц можно продлить социальную карту москвича пенсионеру в москве в 2021 если менялся алрес проживания	Половое воспитание актеры
купить дополнительный отбойник резиновый в задние пружины прадо 95 кузова	лада 11 джили мк 11
"роль наблюдения в психологической науке?"" сочинение эссе"	Кружка Pride of Place Old Cream T&G хоум фиил
математика 6 класс упражнение 4 страница 7	образец платежного поручения по ндфл в 2021 году для ип за работников
в данной летописи рассказывается об историческом событии произошедшем в начале литературное чтение с 12	содержание фильма отличница
зара интернет магазин женской	когда кастрировать шотландца вислоухого
абдуллов рейтинг	радиатор отопителя  на камаз киров
sims 4	Безнадежный разделить на слоги
мини-диваны раскладные детские в минске	авиа трафик  сколько норма ручной клади
кухня леруа мерлен	я люблю свой город ейск перевод на английский язык
как отключить от вайфая других пользователей с телефона программа	bagger simulator
о дивный новый мир олдос хаксли книга скачать бесплатно полная версия	муром 24
sharm dreams resort	сколько стоит наливной 3д пол за квадратный метр в квартире
порно на руском язке	получить свидетельство для инструктора по физической культуре в доу по фгос образец
порочная королева. роман о екатерине говард уэйр э.	аптека лиозно режим работы
скачать рабочую тетрадь по географии 6 класс домогацких бесплатно	болотный ил является
shift 2 видео игра	10 морфемных слов с разбором
распм расписание электричек новосибирск бердск	её какая часть речи
рутгер хауэр в российском фильме	купить ETF GLDM на ММВБ
картинки лукаса	toly braun unshakable перевод
скачать бесплатно песню Когда рядом ты (Remix) ARTEEот Merlin	солгар детские витамины
рецепт винегрета классического	Порно видео и ебут и лижут
какой вид переноса электродного металла наиболее благоприятен для хорошего формирования шва	spotlight 11 pdf
скачать фильмы привет андрей любимый табор возвращается через торрент бесплатно в хорошем качестве без регистрации	удалить аккаунт в инстаграм
детский трехколесный велосипед с беговой дорожкой	купить ванос на е39 новый
мусса ачитара осень	сайт интеграл
Астроном разделить на слоги	новенький 2 сезон смотреть онлайн
монтелар 10 мг инструкция по применению цена	заполни пропуски в предложениях человек в отличие от животных обладает способен к может действовать имеет хорошо развитый
песня капкан конфуз	все руды в террарии 1.4 на андроид последняя версия
чем в давние времена могли торговать греческие купцы	спишите располагая данные фамилии в алфавитном порядке земский
деревня дураков смотреть бесплатно	я тебе подарю на закате зарю текст
Байбөрі баласы Бәмсі- Байрақ туралы жыр Қазақ ертегілері Қазақ эпостары Батырлар жыры Ортақ үндестік кесте	новости долгоруково липецкой области криминальные новости
скачать portal stories mel на русском	последний богатырь 2
вопросы по зельеварению с ответами	я снова жду осенних холодов текст кто автор стихотворения
кристина орбакайте песни	флора и фауна новой зеландии
экспорт мальчики в Иркутск	что значит обозначение ue на стиральной машине самсунг
Москвы не бывает	Кому положена выплата от 8 до 16 лет
Суверенитет государства	таганрог штрафстоянка лесная биржа
колхоз в селе истье калужская область	happy wheels порно
хуавей 40	как снять рубли на украине
scanimage -l	если изменить дату в биосе
как там в балаково	самсунг а 31 не включается экран 
плечо образовано костью предплечье состоит из	погода в нижнезаморском ленинский район крым на 10 дней
цели и задачи дисциплины экологической основы и природопользования	комиксы академии скайлендеров
н новгород ул березовская д 3а	что значит среднее образование
марш беккали мое имя в красно в аромакод.ру	логические задания для 3 класса распечатать
лазерный нивелир bosch professional	сюжетно-ролевая игра в 1 младшей группе картотека с целями
где в россии проходит линия перемены дат в беринговом проливе по 180 меридиану 100 в.д	Колонки 2.0 SVEN SPS-611S
фото в кругу город мекка	незваные гости смотреть онлайн 2015 фильм в хорошем качестве 1080
гдз по геометрии 8	диффузный фиброаденоматоз с преобладанием фиброзного компонента в пожилом возрасте 
в структуре реализации экономичных механизмов выделяют 2 основных элемента	двулучанский Сергей ольховатка
диагностический сканер	ozbnet warcraft 3 ошибка одна из заплаток не найдена
министерство просвещения рф официальный сайт	наличие устойчивых связей 44 фз - что это
Юг сколько звуков	позови меня с собой пугачева скачать
отрывок на живую классику питэр пен	пристень курская область водительские права от военкомата
сколько стоит рюкзак аплика	скорость передачи данных через адсл
айфон  xs цена пятигорск мегафон	удар 2 или добрыня
2 d 16	Общая характеристика нормативной базы дисциплины по
морозильная камера норд фрост дф161 отзывы	великие луки новости
александровский парк пушкин	вампирские войны смотреть онлайн
есенин пугачёвкраткое содержание	а может может быть сможем песня скачать
кожа черная купить екб екатеринбург замша	УЛЬТРАЗВУКОВОй КОНТРОЛь КАЧЕСТВА СВАРНЫХ СОЕДИНЕНИЙ
kyocera m2635dn scanner driver	глицин при эпилепсии у взрослых
çarpık ilişkiler erotik film	hello world by matchattea фулл
концерт малинина в 2019 году в москве	собаки в улан-удэ
эко-папа отель абхазия	свойства квадрата
мультик про динозавров для детей 3 лет	кадиллак ремикс слушать
сериал лжец смотреть онлайн бесплатно все серии подряд в хорошем сезон 2 серия 1	воспаление лёгких симптомы
маша серебреникова	игры для девочек на сколько ты хорошо подходишь парню
люмакс техподдержка	Open bo
кристина орбакайте песни	david gemmell legend in english torrent
число нейтронов в ядре атома 37cl	воспаление лёгких симптомы
Gigant girl seks vedio	настоятель успенск.храма п челюскин владислав форкавец
Г орел купить бу исцелятор	фильмы 2021 душа
Село страчево	ооо метро кэш энд керри официальный сайт
элькар цена в новосибирске	песня дуло
в каком году был построен памятник опера жизнь за царя	rs205l купить
поставь цветы с глазами с ногами и с носом и с руками бесплатно без рекламы	комиксы академии скайлендеров
шатунные шейки коленчатого вала изнашиваются по диаметру	таблица менделеева
автовокзал орша	что такое ротация фото
кукла колдуна на гитаре видео	антонимы к слову дача
На какой срок накладывается давящая повязка после удаления (экстирпации) поднижнечелюстной железы:	ай воне би ю сливе текст транскрипция
экзамен и ответы на прохождения визуально измерительному контролю	актёр олег сорокин
ивар рави прометей 4 скачать fb2 бесплатно полностью	обстановка разбор слова морфемный
в чем прикол 1000 минус 7	купить пистолетмонтажный пд 84 бу в пензе
Как стать самозанятым	динары курс доллара
скачать фильм темное отражение 2018 через торрент бесплатно в хорошем качестве	великие луки новости
в каком году был построен памятник опера жизнь за царя	Speed seks vedio
Enterologia в биологии это	скачать бесплатно песню солнышко в руках
сериал шеф 5 смотреть	система выравнивания плитки мегастрой
диалог знакомство на немецком языке для начинающих	работа на фритюров какой виед или польза и вред
IBEROSTAR SELECTION CANCUN (EX. HILTON CANCUN GOLF & SPA RESORT) 5*	квартет скачать торрент 2012
гатчинская црб официальный сайт	внутренняя ручка обшивки двери ваз 21213
что в повести временных лет предшествовало походу владимира на корсунь	телефон redmi 9 купить в минске
тюрьма фильм	скачать моды на гаррис мод magic wand rewrite
калорийность творога	Андрей Кузмин поэт
денуклеаризация что это значит	андрей римша белорусский поэт
Методики Agile уже применяются при управлении проектами на государственной службе	сказка странствий иваново
антимаг билд томпсона	передаточные числа раздатка g172z man передаточные числа
таурин для похудения. правда или ложь. форум	тест к коронавирусу 60,765  bau/мл
тест к коронавирусу 60,765	таганрог штрафстоянка лесная биржа
полиэтиленовые рукава для упаковки кирпича	нод знакомство с природой в подготовительной
математика 6 класс страница 17 номер 90	метафора это в литературе
галина васильевич тренер по фигурному	little nightmares bundle
магнелис в6 инструкция по применению цена	фильмы 2021 смотреть онлайн бесплатно в хорошем качестве
яндекс карты	приключения тома сойера читать
слова с разделительным мягким знаком	ирина кубанская ютуб
аэропорт в калуге	1кл клас час пожарная безопасность задания
кагоцел как принимать взрослым	bagger simulator
в данной летописи рассказывается об историческом событии произошедшем в начале литературное чтение с 12	продажа панели мдф дуб каньон киров
сборник задач по высшей математике лунгу	жк берег воронеж купить квартиру
как празднуют алтайский праздник	Воронеж ул.Фридриха Энгельса д.18 каб 410 капитальный ремонт
Asian ladyboy amatör sex izle	фото на обои пк бтс
l формы бактерий	скачать фильм голая правда
купить опель фронтера эп от 80000	как отвязать банковскую карту от йота
nike air max 90 купить в спб	бланки адаптационное посещение уроков 1,5 класс психологом
Уральские пельмени про майонез	колготки delight conte
гдз по русскому языку 7 класс ладыженская 2021 год	пр мориса тореза
ай воне би ю сливе текст	что нельзя делать в линзах
произведение михаила ивановича глинки и его характеристику	скачать бесплатно песню Память (Abdul Remix) Ганапи Абуев
леди чаттерлей фильм 2006 смотреть онлайн	пример истории болезни по хирургии
комиксы академии скайлендеров	гей знакомства москва
формирование вычислительных навыков чуракова гдз 2 класс	Порно видео и ебут и лижут
темы для вк vk styles	акт о дезинсекции и дератизации
Что должно иметь решающее значение при выборе водителем скорости движения в темное время суток?	богатства отданные людям проект 3 класс гагарин
зара хочу быть с тобой в печали припев скачать	Какие действия работодателя по результатам испытания при приеме на работу не соответствуют Трудовому кодексу?
скачать фильмы привет андрей любимый табор возвращается через торрент бесплатно в хорошем качестве без регистрации	Порно видео и ебут и лижут
новости сми в ценообразовании	Прикасаться к мужским волосатым ногам
права и обязанности закрытого акционерного общества	прилагательные качественные относительные притяжательные таблица 6 класс
Набор надфилей КОБАЛЬТ алмазных, 140х 50х3 мм, обрезиненные рукоятки (6 шт.) чехол	кто из перечисленных князей не имеет отношения к борьбе за освобождение руси от монгольского ига
свеча иридиевая в авантис	текст токийский гуль
личное снаряжение	Взять микрозайм под 0 процентов на карту ogozaim
К правам ребенка в семье относится право:  свободно распоряжаться имуществом родителей  выбора свободы воспитания  собственности на доходы, полученные родителями  на заботу родителей о себе	танец скачать кадриль
"ЦАО ""Пламя"", Кемеровская область"	galaxy s10 lite
самарканд уй нархи рассрочка 2021	физика приколы
Молодежная ул., дом 10-А	справка 182н за какой период выдается при увольнении
коронавирус как быстро заражение происходит доктор комаровский	пижт расписание занятий
Об определении базового уровня тарифов на перемещение и хранение задержанных транспортных средств на территории Самарской области области	математика 6 класс упражнение 4 страница 7
world sandbox беспла 0.10.2	антисептик на основе хлоргексидина
клетка эукариотическая	кто из перечисленных князей не имеет отношения к борьбе за освобождение руси от монгольского ига
древесина для ботаника 7 букв сканворд	когда революция в россии будет наконец то
+ песни diamonds со словами	новикова оксана в серове
за что критикуют мид	система двухполярного мира
шестой класс математика Никольский страница 16 задание 48	сравнить устройство власти в афинах и спарте составив сравнительную таблицу
слушать оркестр Поля Мориа	лекарственная форма -лаки
из какого чая можно сделать кубики льда для лица	телефон redmi 9 купить в минске
Исторические фильмы о рыцаря правда	что значит среднее образование
Вести Луганск 24 за 16.09 2021	как написать человеку который тебя заблокировал в вк
в указанном списке операций определите какая задолженность является дебиторской а какая кредиторской	вакцинация лотерея
Вопрос 9 Какой метод используется при изучении под микроскопом передвижения инфузории туфельки? Укажите правильный вариант ответа: наблюдения моделирования сравнения эксперимента	вход в никуда фильм
королева последний босс является источником проблем но она приложит все силы для служения народу	торрент секс
не активна кнопка база на гранд смета.ру	локомотив новости
саундтреки из фильма любовь по расчету 2019 комедия	77 78 00 курск номер телефона
судебного участка № 63	клипы меладзе скачать
название сериала про председательшу после войны	курт рассел
тойота спринтер марино крыша с люком	Природно-ресурсный потенциал ДФО учебники
сафин ренат раисович пристав	жк берег воронеж купить квартиру
выбытие из кассы организации на лицевой счет казначейства проводка в бюджетном учреждении	настольный теннис чувашии в контакте
представьте процесс изображенный на рисунке 2.12 в координатах vt и pt комолова	гдз по дидактическому материалу по алгебре 8 класс макарычев
Это наша планета	фосфалюгель инструкция
доказать что число	CAKEWALK SONAR User Manual
количество масла в двигателе авантис	создать презентацию в powerpoint онлайн
сколько стоит рюкзак аплика	судебный участок  64 череповец
yatsı namazı kaç rekat	TF Многофункциональное средство DEVICE #72 сияющий гель СТС07
PARROTEL AQUA PARK RESORT (EX. PARK INN BY RADISSON) 4*	финансовый университет владимир
Abg karaoke hot	семена зерновых культур
abp 383	краски ру официальный сайт москва
ик-52 свердловская область карта	фильм про девушку делающую то что ей говорят с энн хэтэуэй
окр мир 2 класс 1 часть	мидокалм с лидокаином внутримышечно
когда приносят чудотворную икону в елохове	скачать сериал пес снегурочка торрент мп4
Мария опустилаткремль	Crosman Vantage Copperhead отзывы
CAKEWALK REVALVER	как скачать документ с параграфа
конкурентное обратимое ингибирование снимается	çarpık ilişkiler 18
я тебя любил	посадочное место клапана в гбц артикул к4м
A man is known by the company he keeps.	Какие новости в Геленджике на сегодня
сердце ты любви открой минус	какой была реакция дворян на принятие указа о вольных хлебопашцах
создать презентацию	все руды в террарии 1.4 на андроид последняя версия
игра моей судьбы турецкий сериал	Влияние москвы на пьера
кдл пенза режим работы	что в тренде на амазоне
топовая аватарка девочки с цветами	в колонне смесителя происходит химическая реакция превращение сырья в ценный продукт уровень вредных выбросов оптимизация лагранж
как перед числом поставить 0 в эксель	Shop pets adopt me
вин код гибдд	как делают сухое молоко на заводе из чего
ступни ног колет как иголками почему	musica tvoya трек
сопроводительные знаки на упаковке милка	бинд в кс го на смену положения рук
потолок ледяной витас	«Әлемді көз алдыңа келтіру үшін, басқалардың көзіне түсу үшін, адам рухының қадір-қасиетін асқақтата көтеріп, жар салу үшін өз биігің – Мұхтар Әуезов сияқты шыңың болу керек» - пікірдің авторы
Жюпилер про лига лето 21 таблица переходов трансфермаркт	фунгициды для роз
текст песни океан зиверт	калькарея фосфорика у детей при аденоидах
мотовело в бобруйске	world sandbox беспла 0.10.2
диктант 9 класс по русскому языку	age mine
к каким периодам истории русского языка относятся  помещик, городничий, полицмейстер, гусар	вк стулес
xxx anak kecil di perkosa	AMD RX 5700
лада веста дворники какие размеры	сказка собственного сочинения
Выеб за долги	пошаговый выбор на сайте
Часто встречается 212	губка боб горчица
фильмы 2021	в колонне смесителя происходит химическая реакция превращение сырья в ценный продукт уровень вредных выбросов оптимизация лагранж
one step closer	старлайн а91 отключение сигнализации без брелка аварийное
ванны тритон толщина акрила	положение западной Европы  по отношению к главным топливно сырьевым базам
Вопрос 14.  Машина для брошюровки проволокой отпечатанных листов книг, журналов и т. п.	гадание на кофейной гуще онлайн
как называется лагерь для войск	свеча NGK DR8EVX
353730, Краснодарский край, Каневской р-н, Каневская ст-ца, Виноградная ул, дом № 1, корпус А, кв. 1 мировой суд	картинки рэп из цифр
митсубиси универсал	spotlight 11 pdf
one step closer	на надгробье надпись <пусть твой сон будет не долгим> в rezident evil vilage
фунгициды для растений	лада 11 джили мк 11
платежка по фиксированным платежам для ип в 2021 году за себя	чингиз абдуллаев рейтинг книг
геншин изображение острова сэйрай	губка боб горчица
choose the proper words from the list below	Sexxx Masturbate liboschs
погода псков	информатика 3 класс рабочая тетрадь 1 часть горячев стр 9
27 ноября 1971	Гидроксид хлора тип
Эмма Стоун	Математика 6 веленеинномер 121
свеча иридиевая в авантис	май литл пони новое поколение смотреть онлайн бесплатно
влияние декомпрессии на растворимость газов в воде патофизиология	свердлова 54 марийскавтодор
кайт мобил со скачиванием музыки	диета при ротовирусе у взрослых
формирование вычислительных навыков чуракова гдз 2 класс	питьё у татар вода плюс кумыс
рейтинг видеокарт 2021 для майнинга	люхов юрий барановичи
однородные члены в предложении	в воде налитой в чайник и нагреваемой на огне теплопередача осуществляется
16. Раннее детство – начальный этап формирования личности ребенка. Личностное   новообразование раннего детства.	Известны средние скорости полёта птиц вороны 50 км ч скворца 70 км ч
в каком году был построен памятник опера жизнь за царя	а с пушкин декабристы стихи
координатам луча удаления куда может быть	рассказ барбос и жулька краткое содержание
не активна кнопка база на гранд смета.ру	кукла чарли фильм
зара интернет магазин женской	фильмы 2021 смотреть онлайн бесплатно в хорошем качестве
песни игоря талькова	самсунг а 31 не включается экран 
издержки производства которые изменяются называются	родное слово родной русский язык 1-4 класс
asos	где происходит развитие плода
песня только каменное сердце не болит	цкб на фотиевой 10 от метро академическая
я сам обманываться рад стихотворение пушкина	колумб откуда родом
чёрный юмор шутки смешные	небесные стволы в ци мень бин Дин йи и их комбинации
питьё у татар вода плюс кумыс	винилюкс лак для ногтей что это
куда жаловаться на ук	морфологический разбор слова душе молодой
парацетамол инструкция по применению ценабеларусь	japan games android
конкурентное обратимое ингибирование снимается	чему равна скорость движения поезда на перегоне между 2 станциями если 1 половину состояния между станциями он дружил с давлением скоростью 50 километров в час
краска эстель светло русый пепельный	пьеса островского
звуко-буквенный разбор слова настроение	фестиваль черный кот 2021 рязань выступление смотреть онлайн
скачать взлом shadow of death  взлом на бесплатные покупки	калькарея фосфорика у детей при аденоидах
гдз по литературе описать сладко и его делах	скачать аниме обещанный неверленд 1 сезон
one plus 9 pro	Г орел купить бу осциллятор для аргонной сварки
как в сетевом городе оформить ребенка на семейное обучение-	необычайная орфограмма в слове
кто освобождается от налога на дарение недвижимости	кошачий лемур 5 букв
самарканд уй нархи рассрочка 2021	можно ли жить с инфицированным вич инфицированным мужчиной и не заразиться
доигрались читать онлайн бесплатно	the neighbourhood
ст. 346.43 НК РФ	клипы меладзе скачать
КонфЕТЫ Мастерская вкуса вес**	optimum nutrition протеин купить в москве
п. 95 Пленум ВС по наследованию	пошлая молли
глава администрация .Николо-Берёзовское сельское поселение Милютинский район ростовской области	перевал дятлова сериал
подражатель сериал смотреть онлайн бесплатно в хорошем качестве	драка в твери
super burger челябинск	сколько можно хранить опята после сбора до обработки
как правильно пишется слово отраслевой 	Парообразователь - 0,2л, нерж сталь (Модели 12, 16, 20, 24)
Стеклодомкраты Fit отзывы	казанский вокзал на карте метро
новости долгоруково липецкая область	драка в твери
приеду сама сейчас из домодедово нейтральная территория	регулярки для русских слов java
симулятор скорости роблокс	авиабилеты kivi.com отзывы
сборник задач по высшей математике лунгу	Кому положена выплата от 8 до 16 лет
нелли ким	аптека лиозно режим работы
новости шоу-бизнеса россии стархит	казуха и скарамучча
ацетилсалициловая кислота от зубной боли отзывы	телепрограмма газета ростов на дону на июнь 2021 года
электрические панели для отопления купить леруа мерлен новороссийск	что нужно сдавать чтобы пойти на адвоката после 9
Составьте алгоритм расчета токов в ветвях при заданных сопротивлениях резисторов и общего напряжения	ранхигс финансовое право гончарук лекции
лиознова татьяна михайловна википедия	мод на аватара 1 16 5
курсы обучения в печоре	При какой рентгенографической проекции наилучшее выявление слюнного камня, локализованного в переднем отделе выводного протока поднижнечелюстной железы:
choose the proper words from the list below	алексей кузнецов муж анны кузнецовой
бездепы в казино 2021	расстояние между турецкими городами кютахья и измир
лонгслив мужской купить	регламент проезжая часть и тротуар на придомовой территории многоквартирного
ст 31гк рф что это за статья	Saw porno skachat
Йен сомерхолдер и его семейная жизнь	Overwatch porn
финансовый университет	6 сезон пацанки инстаграм
че я лысая дзен	гей знакомства москва
как там в балаково	ответы на экзамен микроэкономика синергия
фунгициды для растений	пва анапа подслушано в анапе
кфс воткинск 129	рифма к слову она
оперу спб гту банка россии адрес	обучение медицинское образование заочное высшее
ноздрин спрей купить в аптеке семейной в белогорске крым	кухня гостиная 30 кв м дизайн и планировка с барной стойкой
очищение звезда органов	самарканд уй нархи
приоткроет завесу истории	угольный фильтр для вытяжки грауде купить в екатеринбурге
телефон redmi 9	экранизации книг стивена кинга список лучших
сериал шеф 5 смотреть	энди уорхол
как узнать кто наводит порчу и заставить явиться	анастасия степная санкт петербург
отель мэриголд лучший из экзотических скачать торрент	как скрыть невидимые папки windows 70
спбгипср портал	моргает светодиод fwd на частотнике
утомительные хлопоты	УЛЬТРАЗВУКОВОй КОНТРОЛь КАЧЕСТВА СВАРНЫХ СОЕДИНЕНИЙ
когда вышел 4 сезон звёздные войны повстанцы	джаз фанара резорт шарм-эль-шейх цены
апельсин донской автострахование тульская область	как заставить мужчину сходить от тебя с ума 10 работающих способов
строение и многообразие покрытосеменных растений 6 класс	олабыстн полярный видео
Известны средние скорости полёта птиц	айна песня айна
замена лампочек в приборной панели печки матиз	все руды в террарии 1.4 на андроид последняя версия
мотовело в бобруйске	«Неполная семья»: понятие фз
ивар рави прометей 4 скачать fb2 бесплатно полностью	зерно томск
заключение контрактов в детских садах по 44 закону	Вязание спицами ленто
гибдд саратов замена прав через госуслуги	пряно румяно омск меню
